ba	ba
biao	bc
ben	bf
beng	bg
bang	bh
bi	bi
ban	bj
bao	bk
bai	bl
bian	bm
bin	bn
bo	bo
bu	bu
bie	bx
bing	by
bei	bz
ca	ca
cou	cb
ce	ce
cen	cf
ceng	cg
cang	ch
ci	ci
can	cj
cao	ck
cai	cl
cuo	co
cun	cp
cuan	cr
cong	cs
cu	cu
cui	cv
da	da
dou	db
diao	dc
de	de
den	df
deng	dg
dang	dh
di	di
dan	dj
dao	dk
dai	dl
dian	dm
duo	do
dun	dp
diu	dq
duan	dr
dong	ds
du	du
dui	dv
dia	dw
die	dx
ding	dy
dei	dz
fa	fa
fou	fb
fiao	fc
fen	ff
feng	fg
fang	fh
fan	fj
fo	fo
fu	fu
fei	fz
ga	ga
gou	gb
guang	gd
ge	ge
gen	gf
geng	gg
gang	gh
gan	gj
gao	gk
gai	gl
guo	go
gun	gp
guan	gr
gong	gs
gu	gu
gui	gv
gua	gw
guai	gy
gei	gz
ha	ha
hou	hb
huang	hd
he	he
hen	hf
heng	hg
hang	hh
han	hj
hao	hk
hai	hl
huo	ho
hun	hp
huan	hr
hong	hs
hu	hu
hui	hv
hua	hw
huai	hy
hei	hz
ch	i
cha	ia
chou	ib
chuang	id
che	ie
chen	if
cheng	ig
chang	ih
chi	ii
chan	ij
chao	ik
chai	il
chuo	io
chun	ip
chuan	ir
chong	is
chu	iu
chui	iv
chua	iw
chuai	iy
jiao	jc
jiang	jd
ji	ji
jian	jm
jin	jn
jun	jp
jiu	jq
juan	jr
jiong	js
jue	jt
ju	ju
jue	jv
jia	jw
jie	jx
jing	jy
ka	ka
kou	kb
kuang	kd
ke	ke
ken	kf
keng	kg
kang	kh
kan	kj
kao	kk
kai	kl
kuo	ko
kun	kp
kuan	kr
kong	ks
ku	ku
kui	kv
kua	kw
kuai	ky
kei	kz
la	la
lou	lb
liao	lc
liang	ld
le	le
leng	lg
lang	lh
li	li
lan	lj
lao	lk
lai	ll
lian	lm
lin	ln
luo	lo
lun	lp
liu	lq
luan	lr
long	ls
lue	lt
lu	lu
lv|lue	lv
lia	lw
lie	lx
ling	ly
lei	lz
ma	ma
mou	mb
miao	mc
me	me
men	mf
meng	mg
mang	mh
mi	mi
man	mj
mao	mk
mai	ml
mian	mm
min	mn
mo	mo
miu	mq
mu	mu
mie	mx
ming	my
mei	mz
na	na
nou	nb
niao	nc
niang	nd
ne	ne
nen	nf
neng	ng
nang	nh
ni	ni
nan	nj
nao	nk
nai	nl
nian	nm
nin	nn
nuo	no
nun	np
niu	nq
nuan	nr
nong	ns
nue	nt
nu	nu
nv|nue	nv
nie	nx
ning	ny
nei	nz
a	oa
ou	ob
e	oe
en	of
eng	og
ang	oh
an	oj
ao	ok
ai	ol
o	oo
er	or
ei	oz
pa	pa
pou	pb
piao	pc
pen	pf
peng	pg
pang	ph
pi	pi
pan	pj
pao	pk
pai	pl
pian	pm
pin	pn
po	po
pu	pu
pie	px
ping	py
pei	pz
qiao	qc
qiang	qd
qi	qi
qian	qm
qin	qn
qun	qp
qiu	qq
quan	qr
qiong	qs
que	qt
qu	qu
que	qv
qia	qw
qie	qx
qing	qy
rou	rb
re	re
ren	rf
reng	rg
rang	rh
ri	ri
ran	rj
rao	rk
ruo	ro
run	rp
ruan	rr
rong	rs
ru	ru
rui	rv
rua	rw
sa	sa
sou	sb
se	se
sen	sf
seng	sg
sang	sh
si	si
san	sj
sao	sk
sai	sl
suo	so
sun	sp
suan	sr
song	ss
su	su
sui	sv
ta	ta
tou	tb
tiao	tc
te	te
teng	tg
tang	th
ti	ti
tan	tj
tao	tk
tai	tl
tian	tm
tuo	to
tun	tp
tuan	tr
tong	ts
tu	tu
tui	tv
tie	tx
ting	ty
tei	tz
sh	u
sha	ua
shou	ub
shuang	ud
she	ue
shen	uf
sheng	ug
shang	uh
shi	ui
shan	uj
shao	uk
shai	ul
shuo	uo
shun	up
shuan	ur
shu	uu
shui	uv
shua	uw
shuai	uy
shei	uz
zh	v
zha	va
zhou	vb
zhuang	vd
zhe	ve
zhen	vf
zheng	vg
zhang	vh
zhi	vi
zhan	vj
zhao	vk
zhai	vl
zhuo	vo
zhun	vp
zhuan	vr
zhong	vs
zhu	vu
zhui	vv
zhua	vw
zhuai	vy
zhei	vz
wa	wa
wen	wf
weng	wg
wang	wh
wan	wj
wai	wl
wo	wo
wu	wu
wei	wz
xiao	xc
xiang	xd
xi	xi
xian	xm
xin	xn
xun	xp
xiu	xq
xuan	xr
xiong	xs
xue	xt
xu	xu
xue	xv
xia	xw
xie	xx
xing	xy
ya	ya
you	yb
ye	ye
yang	yh
yi	yi
yan	yj
yao	yk
yin	yn
yo	yo
yun	yp
yuan	yr
yong	ys
yue	yt
yu	yu
yue	yv
ying	yy
za	za
zou	zb
ze	ze
zen	zf
zeng	zg
zang	zh
zi	zi
zan	zj
zao	zk
zai	zl
zuo	zo
zun	zp
zuan	zr
zong	zs
zu	zu
zui	zv
zei	zz